10
##0##.#
#21##.#
#3#####
#45####
##67###
###8###
###9###
