##.##.#
#..##.#
#.#####
#..####
##..###
###.###
